########................########
#..............................#
#..............................#
#..............................#
#..............................#
................................
................................
................................
................................
................................
................................
#..............................#
#..............................#
#..............................#
#..............................#
########................########
